.....*.*.*.....*.*.*.....
**.***.*.*.*.***.*.***.**
.......*...*.......*...*.
.*.***.*********.*****.*.
.*.*.*.......*.........*.
**.*.***.*.*.***.*.***.*.
...*.....*.*.....*...*.*.
**.*****.*************.*.
.*.*.....*.*.*.*.*...*...
.*********.*.*.*.***.***.
.............*...........
************.***.*.*****.
...*...*.*.......*.*...*.
**.***.*.*************.*.
.....*.............*...*.
****.*****.*.*.***.***.*.
.......*...*.*.*.*...*..S
.*.***.*****.*.*.***.***.
.*...*.*.....*.*.*.......
****.***********.*.***.*.
...............*.....*.*.
.*.***.*.*.***.*.***.***.
.*.*...*.*.*.....*...*...
**.***.***.*.*.***.*.*.*.
E..*...*...*.*.*...*.*.*.
